,position,token,information_gain,total_ocurences,total_flaky_occurences,total_nonflaky_occurences
0,0,job,0.14491500049749653,530,525,5
1,1,table,0.1029796587876006,414,406,8
2,2,id,0.1004319891651803,577,525,52
3,3,services,0.09776092568455451,378,371,7
4,4,action,0.09721660905697455,396,388,8
5,5,oozie,0.09424476112449412,346,346,0
6,6,loc,0.08793936976295982,2804,1402,1402
7,7,coord,0.08263782720878801,307,307,0
8,8,xml,0.07528721680908017,356,341,15
9,9,getid,0.07462750408637384,288,287,1
10,10,coordinator,0.07418817836510425,278,278,0
11,11,get,0.06913188837222863,2194,1260,934
12,12,workflow,0.06333959802931788,240,240,0
13,13,throws_keyword,0.06156855531411635,2348,1327,1021
14,14,getstatus,0.0613196196267442,248,246,2
15,15,record,0.05969417540133884,314,296,18
16,16,service,0.059092626070019125,451,383,68
17,17,jpa,0.05411552613636775,207,207,0
18,18,jpaservice,0.05218170354304141,200,200,0
19,19,wf,0.04998120143983045,192,192,0
20,20,coordinatorjob,0.047790824376541696,184,184,0
21,21,call,0.04777561167742202,374,297,77
22,22,getfilesystem,0.04728787446811885,219,213,6
23,23,case,0.04693691237083236,274,246,28
24,24,coordinatoraction,0.04289899445863557,166,166,0
25,25,app,0.04237018377976755,221,210,11
26,26,execute,0.04031521206350207,325,279,46
27,27,system,0.038775062036519474,533,405,128
28,28,addrecordtocoordjobtable,0.03859244700863951,150,150,0
29,29,keywordcount,0.03852093132358067,2804,1402,1402
30,30,assert,0.03560658332123451,2305,1193,1112
31,31,node,0.035532751866200724,233,208,25
32,32,evaluate,0.03543145475608496,141,139,2
33,33,then,0.034294580802071595,293,98,195
34,34,return,0.03409860310087206,236,25,211
35,35,cluster,0.03403930152807242,179,170,9
36,36,status,0.03324142518846224,450,350,100
37,37,date,0.03233894253563664,219,195,24
38,38,wait,0.03210692495278452,273,228,45
39,39,dateutils,0.03194031979357054,125,125,0
40,40,mockito,0.0314313795624163,188,13,175
41,41,thenreturn,0.03141988413454861,192,14,178
42,42,cmd,0.029001299475374494,134,130,4
43,43,workflowjob,0.02877990985739433,113,113,0
44,44,runtest,0.02851748327680125,112,112,0
45,45,add,0.028495909319878242,759,515,244
46,46,getfstestcasedir,0.02825520067724796,111,111,0
47,47,to,0.02821699478096816,1248,766,482
48,48,dfs,0.027789087764691387,130,125,5
49,49,jobid,0.027731066761765424,109,109,0
50,50,00,0.02712611235595966,133,123,10
51,51,actions,0.027021068744796713,112,111,1
52,52,tz,0.026753004727361012,113,112,1
53,53,client,0.02600820734867338,314,243,71
54,54,parsedateoozietz,0.02590110930838506,102,102,0
55,55,addrecordtocoordactiontable,0.025640257495420413,101,101,0
56,56,bundle,0.025640257495420364,101,101,0
57,57,workflowinstance,0.025379547865147498,100,100,0
58,58,end,0.025054599430097853,263,207,56
59,59,parse,0.02490775584211359,278,217,61
60,60,coord-action-get,0.024338127940381843,96,96,0
61,61,waitfor,0.02403090333539299,133,125,8
62,62,nodes,0.0238202231724289,131,122,9
63,63,oozieclient,0.023298970050584154,92,92,0
64,64,apppath,0.022780236168114656,90,90,0
65,65,gettestuser,0.02252107993508555,89,89,0
66,66,is_security_enabled,0.02252107993508554,89,89,0
67,67,utils,0.02216949172323475,535,381,154
68,68,00z,0.022003188092312085,87,87,0
69,69,workflowaction,0.022003188092312068,87,87,0
70,70,for,0.021968792636129754,630,428,202
71,71,run,0.021659910301863546,372,264,108
72,72,restconstants,0.021227399515342166,84,84,0
73,73,t01,0.02122739951534216,84,84,0
74,74,is_,0.0208095698969801,90,89,1
75,75,numdatanodes,0.020452866184368153,81,81,0
76,76,geterrorcode,0.020452866184368146,81,81,0
77,77,session,0.02039614774278317,126,86,40
78,78,charsets,0.020304529231837645,88,1,87
79,79,security_,0.02024326085129884,91,89,2
80,80,gettestcasedir,0.02019496661909645,80,80,0
81,81,x,0.02018869978253952,143,110,33
82,82,mock,0.020080308155599344,306,92,214
83,83,errorcode,0.01993720589923284,79,79,0
84,84,standard,0.01978321390176741,86,1,85
85,85,addrecordtowfjobtable,0.019679583868913955,78,78,0
86,86,verify,0.019602869545091803,374,100,274
87,87,standardcharsets,0.01927094836581008,84,1,83
88,88,addrecordtobundlejobtable,0.019164755254829538,76,76,0
89,89,action2,0.01916475525482952,76,76,0
90,90,final_keyword,0.01902992530837054,836,387,449
91,91,return_keyword,0.018545320490387984,349,253,96
92,92,classes,0.018453787299313816,84,80,4
93,93,constants,0.01831936706549229,139,124,15
94,94,user,0.018302381409119113,295,194,101
95,95,data,0.01824793356462687,348,250,98
96,96,dir,0.018168272682635538,364,262,102
97,97,new_keyword,0.01810160847598043,2116,1107,1009
98,98,action1,0.017880099928713186,71,71,0
99,99,fs,0.01768561979993815,350,254,96
100,100,setsystemproperty,0.017623581836342328,70,70,0
101,101,one,0.01747149683516902,204,154,50
102,102,config,0.01745322422316303,189,104,85
103,103,el,0.017367201042960644,69,69,0
104,104,create,0.017226184933864318,798,460,338
105,105,method,0.01716268204568507,162,51,111
106,106,script,0.017093902994342842,72,69,3
107,107,row,0.01696118383235624,79,76,3
108,108,url,0.016927279791613976,231,154,77
109,109,boolean_keyword,0.01682202823448394,198,161,37
110,110,num,0.01671690360102554,192,151,41
111,111,uri,0.016511641080475377,225,168,57
112,112,enabled,0.016453409590369047,123,109,14
113,113,test,0.01637476731076282,2517,1250,1267
114,114,randomutils,0.016343047800054578,65,65,0
115,115,running,0.01633781537910651,86,81,5
116,116,block,0.016333685744822315,119,104,15
117,117,metrics,0.016068667790019142,86,7,79
118,118,rest,0.0159378969193122,103,94,9
119,119,submit,0.015832921221458386,114,93,21
120,120,functions,0.015831791002914132,63,63,0
121,121,//,0.015574217642726353,84,80,4
122,122,matchers,0.015535781666303422,74,2,72
123,123,getcontexturl,0.015321079135702229,61,61,0
124,124,oozieurl,0.015321079135702229,61,61,0
125,125,null,0.015227505462463153,569,368,201
126,126,init,0.015143284365566754,288,196,92
127,127,shutdown,0.014831838595184277,175,142,33
128,128,dag,0.014810910988969073,59,59,0
129,129,${coord,0.014810910988969068,59,59,0
130,130,z,0.014720114766444279,123,102,21
131,131,set,0.01460586468099434,1104,652,452
132,132,print,0.014600870462170366,126,98,28
133,133,end_,0.014556030433969094,58,58,0
134,134,not,0.01441144987114493,836,474,362
135,135,end_points,0.01430128535743494,57,57,0
136,136,servlet_classes,0.01430128535743494,57,57,0
137,137,waitactive,0.01430128535743494,57,57,0
138,138,actionxml,0.014301285357434915,57,57,0
139,139,context,0.014242554402237182,372,159,213
140,140,conf,0.014203124697046024,732,451,281
141,141,getconf,0.014077912659284583,120,105,15
142,142,coordjob,0.014046675609357406,56,56,0
143,143,def,0.014032397984491955,56,55,1
144,144,update,0.01394543691444723,129,103,26
145,145,code,0.013745409222188698,246,175,71
146,146,active,0.013716313841151823,93,72,21
147,147,stuff,0.013714763223007926,65,2,63
148,148,kill,0.01367619137163369,59,58,1
149,149,executor,0.013634813209322541,157,125,32
150,150,play,0.013537861499830911,54,54,0
151,151,xmlutils,0.0135378614998309,54,54,0
152,152,dfsconfigkeys,0.013537861499830897,54,54,0
153,153,1,0.013452255141507777,414,258,156
154,154,file,0.013332760815294203,617,390,227
155,155,coordelfunctions,0.013283656839652505,53,53,0
156,156,t23,0.013283656839652493,53,53,0
157,157,runnable,0.013270172909619356,53,52,1
158,158,given,0.013216739980144464,79,74,5
159,159,59,0.013216449741947179,56,54,2
160,160,select,0.01320510705673506,68,65,3
161,161,destroy,0.012888028705316499,139,112,27
162,162,where,0.01285085902368498,72,68,4
163,163,addrecordtowfactiontable,0.012775651563572604,51,51,0
164,164,check,0.012565424732241554,355,236,119
165,165,manager,0.012561020259337058,130,99,31
166,166,executescripttemplate,0.012521850650482627,50,50,0
167,167,scriptexecutor,0.012521850650482627,50,50,0
168,168,cql,0.012521850650482617,50,50,0
169,169,path,0.012375494463657894,429,248,181
170,170,start,0.012371106544846952,470,312,158
171,171,datanode,0.012268184022994514,49,49,0
172,172,addrecordtobundleactiontable,0.01226818402299451,49,49,0
173,173,mockdagengineservice,0.01226818402299451,49,49,0
174,174,c,0.012218688336000275,145,105,40
175,175,from,0.012214506647942673,282,179,103
176,176,codec,0.012124066112792558,52,1,51
177,177,catch_keyword,0.012098098851543015,583,361,222
178,178,2009-02-01,0.012014651533148948,48,48,0
179,179,xmlns=\,0.012014651533148945,48,48,0
180,180,parsexml,0.012014651533148943,48,48,0
181,181,db,0.01201465153314894,48,48,0
182,182,public_keyword,0.011909832265596228,2800,1399,1401
183,183,http,0.011834672075180797,198,83,115
184,184,array,0.011796703789223106,136,28,108
185,185,addnode,0.011761253033244892,47,47,0
186,186,servlet_,0.011666273104530155,59,57,2
187,187,connection,0.011619461533415492,170,131,39
188,188,error,0.011598587482332959,244,173,71
189,189,assertnotnull,0.011586676858988496,383,264,119
190,190,nextlong,0.011573397218684535,72,67,5
191,191,immutablemap,0.011500986728439529,53,52,1
192,192,bean,0.011390736531766851,74,68,6
193,193,id1,0.011328913429621251,51,50,1
194,194,long,0.011296035431015303,179,117,62
195,195,argument,0.011291675555739369,69,5,64
196,196,getnamenodeuri,0.011254857413712238,45,45,0
197,197,hcat,0.011254857413712238,45,45,0
198,198,points,0.01124651373260131,62,59,3
199,199,equals,0.011219894021032573,1576,876,700
200,200,fail,0.011165724549739468,486,304,182
201,201,wrap,0.011145923815786574,71,37,34
202,202,jobs,0.011001859999942618,44,44,0
203,203,_test,0.010886193046398424,78,70,8
204,204,been,0.010836688460327641,124,56,68
205,205,insert,0.010829264927815309,56,53,3
206,206,time,0.010795981214835753,406,254,152
207,207,should,0.010776784615242719,463,206,257
208,208,map,0.010754537104848166,148,101,47
209,209,channel,0.010727384218444474,73,7,66
210,210,as,0.01071605692432429,334,225,109
211,211,core,0.010620405315221633,55,6,49
212,212,ae,0.010517941783480169,49,47,2
213,213,take,0.010517364230231082,53,45,8
214,214,xdatatestcase,0.010496265230928406,42,42,0
215,215,key,0.010303658250249901,247,103,144
216,216,stack,0.0102519684102826,98,83,15
217,217,transit,0.010243667583049228,41,41,0
218,218,>,0.010112851129587899,64,59,5
219,219,info,0.01010909590145044,229,160,69
220,220,try_keyword,0.010086346277991938,800,474,326
221,221,equalto,0.010023447846010222,47,1,46
222,222,builddatekey,0.00999120289824821,40,40,0
223,223,header,0.009873007208658788,196,93,103
224,224,=,0.009761963573346962,112,84,28
225,225,purge,0.009738871030833172,39,39,0
226,226,rerun,0.009738871030833172,39,39,0
227,227,name=\,0.00973887103083317,39,39,0
228,228,getjobtrackeruri,0.009738871030833166,39,39,0
229,229,current,0.009729485796859522,221,140,81
230,230,trace,0.009718227538444226,98,81,17
231,231,assertequals,0.009706614091202659,1512,849,663
232,232,resource,0.009595644389140224,107,73,34
233,233,<configuration>,0.009516969475545192,50,48,2
234,234,2009-02-01t01,0.009486671835357518,38,38,0
235,235,-oozie,0.009486671835357507,38,38,0
236,236,getresourceasreader,0.009486671835357507,38,38,0
237,237,ninjaproperties,0.009486671835357507,38,0,38
238,238,},0.009465493545733741,66,58,8
239,239,eval,0.009415253783010061,44,43,1
240,240,response,0.009398957727772906,229,114,115
241,241,build,0.009377598563124548,259,181,78
242,242,have,0.009328459393656566,183,86,97
243,243,reader,0.009321768955660378,80,49,31
244,244,job1,0.009234605166626103,37,37,0
245,245,jms,0.0092346051666261,37,37,0
246,246,</job-tracker>,0.009234605166626095,37,37,0
247,247,<job-tracker>,0.009234605166626095,37,37,0
248,248,<name-node>,0.009234605166626095,37,37,0
249,249,actionid,0.009234605166626095,37,37,0
250,250,createurl,0.009234605166626095,37,37,0
251,251,dsl,0.009234605166626095,37,37,0
252,252,entity/insert_single_row,0.009234605166626095,37,37,0
253,253,simpleentity/insert_single_row,0.009234605166626095,37,37,0
254,254,</name-node>,0.009234605166626081,37,37,0
255,255,months,0.009225324699142116,37,36,1
256,256,provider,0.009120409394223906,87,15,72
257,257,groups,0.009096915398508187,51,19,32
258,258,byte,0.009037367718722628,114,22,92
259,259,printstacktrace,0.009019370531061641,92,78,14
260,260,bytes,0.008988118261353529,213,82,131
261,261,argumentmatchers,0.008982670879687696,36,0,36
262,262,getnamenode,0.008982670879687696,36,36,0
263,263,instance,0.008981106136828256,190,138,52
264,264,simple,0.008948203855014023,109,75,34
265,265,month,0.008846132635673012,42,41,1
266,266,invoke,0.008768964159095612,73,27,46
267,267,file1,0.008767850624965032,54,49,5
268,268,h,0.008731945585244146,92,72,20
269,269,actionnum,0.00873086882983988,35,35,0
270,270,codectestutils,0.00873086882983988,35,0,35
271,271,dfstestutil,0.00873086882983988,35,35,0
272,272,request,0.008714689652956676,265,111,154
273,273,createfile,0.008676074075866923,73,63,10
274,274,long_keyword,0.008644282480495862,219,145,74
275,275,launcher,0.008602860015671003,46,42,4
276,276,succeeded,0.00857946163871897,50,47,3
277,277,process,0.008563519192912032,73,13,60
278,278,next,0.0084962263833866,175,122,53
279,279,immutable,0.0084955771672179,62,56,6
280,280,cookie,0.008492408157946094,43,6,37
281,281,exception,0.008490677998666572,305,136,169
282,282,currentdateplusmonth,0.008479198872626506,34,34,0
283,283,dateafter,0.008479198872626506,34,34,0
284,284,evalandwrap,0.008479198872626506,34,34,0
285,285,getcurrentdateafterincrementinginmonths,0.008479198872626506,34,34,0
286,286,incrementing,0.008479198872626506,34,34,0
287,287,any,0.008440670646881716,133,36,97
288,288,sleep,0.008420384977707685,186,128,58
289,289,list,0.00841715656779594,325,210,115
290,290,\,0.00839032490836161,208,139,69
291,291,content-type,0.00833302365859612,37,36,1
292,292,result,0.008289501897558733,163,50,113
293,293,thrown,0.008280364194744401,71,10,61
294,294,0000000-,0.008227660863836854,33,33,0
295,295,coordjobgetcmd,0.008227660863836854,33,33,0
296,296,mockcontroller,0.008227660863836854,33,0,33
297,297,param1,0.008227660863836854,33,0,33
298,298,topic,0.008227660863836854,33,33,0
299,299,two,0.008198967250992822,87,70,17
300,300,hdfs,0.008093744338421138,57,50,7
301,301,message,0.00808894900339916,209,127,82
302,302,ninja,0.008071297287666365,73,13,60
303,303,property,0.008066031542600195,197,131,66
304,304,options,0.008028130057617322,44,4,40
305,305,child,0.00800304882579397,55,47,8
306,306,times,0.007996101006493674,90,17,73
307,307,sla,0.007976254659505445,32,32,0
308,308,namesystem,0.007976254659505442,32,32,0
309,309,interactions,0.00797625465950544,32,0,32
310,310,command,0.007975036647914616,72,60,12
311,311,namenode,0.007968277678109512,32,31,1
312,312,peer,0.007941516505613009,32,27,5
313,313,random,0.00786092531739529,113,81,32
314,314,factory,0.007855517550727942,79,19,60
315,315,when,0.007845665491069641,358,126,232
316,316,copycharstream,0.007724980115907852,31,31,0
317,317,frombasetable,0.007724980115907852,31,31,0
318,318,getappname,0.007724980115907852,31,31,0
319,319,getnamesystem,0.007724980115907852,31,31,0
320,320,datain,0.007724980115907846,31,31,0
321,321,localoozie,0.007724980115907846,31,31,0
322,322,getbytes,0.007689325485439748,82,13,69
323,323,enqueue,0.007588910268028492,39,35,4
324,324,0,0.007558205703993308,204,116,88
325,325,dependency,0.007557708243005785,36,35,1
326,326,purged,0.007473878833202275,32,31,1
327,327,constant,0.007473837089570058,30,0,30
328,328,job2,0.007473837089570058,30,30,0
329,329,commonconfigurationkeys,0.007473837089570057,30,0,30
330,330,jobconf,0.007473837089570057,30,30,0
331,331,wfjob,0.007473837089570057,30,30,0
332,332,so,0.007443498496268392,96,44,52
333,333,mkdirs,0.007434046660491456,109,86,23
334,334,delete,0.0073344048661901935,180,122,58
335,335,token,0.007312541011027687,122,45,77
336,336,commit,0.007222864416091147,31,30,1
337,337,geturl,0.007222825437256705,29,29,0
338,338,outbuf,0.007222825437256699,29,0,29
339,339,lib,0.007215628266805924,29,28,1
340,340,event,0.007150148853499025,79,60,19
341,341,controller,0.007115797257488566,44,3,41
342,342,setrequestmethod,0.007102665137772493,35,34,1
343,343,int_keyword,0.007078975154394497,349,212,137
344,344,e,0.007050939842979483,252,166,86
345,345,tablename,0.0069719450159750635,28,28,0
346,346,dependencies,0.006971945015975063,28,28,0
347,347,cat,0.006971945015975061,28,28,0
348,348,z\,0.00697194501597506,28,28,0
349,349,frequency=\,0.006971945015975058,28,28,0
350,350,t00,0.006971945015975058,28,28,0
351,351,<worklfow-app/>,0.006971945015975055,28,28,0
352,352,coding,0.006971945015975055,28,0,28
353,353,ninjaconstant,0.006971945015975055,28,0,28
354,354,setbody,0.006971945015975055,28,28,0
355,355,unit_,0.006971945015975055,28,28,0
356,356,-,0.006955319991033571,109,64,45
357,357,<property>,0.006937660586405773,39,37,2
358,358,endtime,0.006916680689041935,39,36,3
359,359,</property>,0.0069064257757309915,39,37,2
360,360,re,0.006845325509579149,47,41,6
361,361,encoder,0.006816224197116298,37,2,35
362,362,close,0.006796719213176952,344,210,134
363,363,default,0.006793872585637017,213,85,128
364,364,common,0.006782853712256871,57,7,50
365,365,decode,0.006768652245935399,33,1,32
366,366,crud,0.006721195682976647,27,27,0
367,367,unit_testing,0.006721195682976647,27,27,0
368,368,nominal,0.006721195682976646,27,27,0
369,369,/>,0.006721195682976643,27,27,0
370,370,transferred,0.006721195682976643,27,0,27
371,371,timezone=\,0.0067211956829766415,27,27,0
372,372,utc\,0.0067211956829766415,27,27,0
373,373,year}/${,0.0067211956829766415,27,27,0
374,374,spy,0.006707499516000914,45,7,38
375,375,days,0.006701815895625566,37,31,6
376,376,pause,0.0066841337086735895,35,33,2
377,377,starttime,0.006673775397919834,38,36,2
378,378,template,0.006637298368586716,65,54,11
379,379,accept,0.006610694716369438,57,32,25
380,380,stream,0.006610039179482489,239,130,109
381,381,length,0.006551250649047582,142,40,102
382,382,append,0.0065129519675517535,124,43,81
383,383,00z\,0.006470577295755176,26,26,0
384,384,<coordinator-app,0.0064705772957551755,26,26,0
385,385,end=\,0.0064705772957551755,26,26,0
386,386,getbytestransferred,0.0064705772957551755,26,0,26
387,387,start=\,0.0064705772957551755,26,26,0
388,388,wc,0.0064705772957551755,26,26,0
389,389,family,0.006470577295755169,26,26,0
390,390,</configuration>,0.0064417787487178945,37,35,2
391,391,finally_keyword,0.006431564903655985,349,211,138
392,392,and,0.006345520686925624,478,278,200
393,393,replication,0.006276036932031085,38,34,4
394,394,encode,0.006263163958819653,43,4,39
395,395,parsed,0.006251517263525668,29,1,28
396,396,getjob,0.0062200897120412305,25,25,0
397,397,inbuf,0.0062200897120412305,25,0,25
398,398,</action>,0.00622008971204123,25,25,0
399,399,<app-path>hdfs,0.00622008971204123,25,25,0
400,400,dat,0.00622008971204123,25,25,0
401,401,launchermapper,0.00622008971204123,25,25,0
402,402,killed,0.006220089712041223,25,25,0
403,403,ioutils,0.006188381113632218,86,69,17
404,404,tobytes,0.006178700171558714,31,30,1
405,405,io,0.00615595756600412,143,83,60
406,406,assertsame,0.006141770433189952,31,1,30
407,407,getentity,0.006141770433189952,31,1,30
408,408,mode,0.006141467575804329,76,20,56
409,409,param,0.006109082860339816,52,9,43
410,410,datanodes,0.006100782411038816,32,30,2
411,411,region,0.006100782411038814,32,30,2
412,412,validation,0.006096210480483997,37,4,33
413,413,engine,0.006036619901684867,111,82,29
414,414,waiting,0.0060341402385920085,56,47,9
415,415,write,0.006006263729475721,328,201,127
416,416,createcontext,0.0059798662737711,35,33,2
417,417,plus,0.0059798662737711,35,33,2
418,418,</coordinator-app>,0.005969732789813248,24,24,0
419,419,</workflow>,0.005969732789813248,24,24,0
420,420,<action>,0.005969732789813248,24,24,0
421,421,<workflow>,0.005969732789813248,24,24,0
422,422,123,0.005969732789813247,24,0,24
423,423,kp,0.0059697327898132445,24,0,24
424,424,dataset=\,0.005969732789813241,24,24,0
425,425,subworkflow,0.00596973278981324,24,24,0
426,426,ssl,0.005912327505542559,27,1,26
427,427,buffer,0.005910262506096293,118,31,87
428,428,content,0.005900315691314531,134,38,96
429,429,name,0.005871727871336124,606,349,257
430,430,openconnection,0.005822631463282645,53,46,7
431,431,is,0.005811940341271509,736,358,378
432,432,f,0.005784174666856046,73,52,21
433,433,log,0.005744516045839919,195,119,76
434,434,cache,0.005740759654029591,66,31,35
435,435,contains,0.005733754237707439,306,190,116
436,436,zero,0.005732192196719536,33,4,29
437,437,logging,0.005719506387279758,23,0,23
438,438,replicas,0.005719506387279758,23,23,0
439,439,framework,0.005719506387279757,23,0,23
440,440,path=\,0.005719506387279757,23,23,0
441,441,/workflow,0.005719506387279756,23,23,0
442,442,</java>,0.005719506387279756,23,23,0
443,443,<java>,0.005719506387279756,23,23,0
444,444,<main-class>,0.005719506387279756,23,23,0
445,445,<name>input,0.005719506387279756,23,23,0
446,446,59z,0.005719506387279754,23,23,0
447,447,<dataset,0.005719506387279754,23,23,0
448,448,initial-instance=\,0.005719506387279754,23,23,0
449,449,dump,0.005697371815540165,33,4,29
450,450,open,0.005693344932445021,141,97,44
451,451,corematchers,0.005664325561847991,29,1,28
452,452,json,0.005650376803129756,66,50,16
453,453,recovery,0.005639566909402664,27,26,1
454,454,sub,0.005596882354204877,41,35,6
455,455,copy,0.005591216020489334,74,53,21
456,456,a\,0.005586333650374465,36,30,6
457,457,successful,0.005565139548352517,44,38,6
458,458,builder,0.005532728688149828,56,9,47
459,459,tracker,0.005498848255221571,57,47,10
460,460,*,0.005495532301439336,151,104,47
461,461,decoder,0.005482509200774473,28,1,27
462,462,local_,0.005470767844676658,31,29,2
463,463,dataout,0.00546941036289744,22,22,0
464,464,schema,0.005469410362897437,22,22,0
465,465,<controls>,0.005469410362897435,22,22,0
466,466,action3,0.005469410362897435,22,22,0
467,467,line,0.005444440228047336,59,14,45
468,468,secret,0.005418722919306068,35,5,30
469,469,args,0.005397309401636941,77,56,21
470,470,authentication,0.005396043650171615,53,8,45
471,471,bulk,0.005389207703439758,26,25,1
472,472,if_keyword,0.005386513051608213,238,154,84
473,473,blocks,0.005382701993239622,45,38,7
474,474,gettime,0.00535064482063792,84,66,18
475,475,server,0.005330498432523892,275,135,140
476,476,convert,0.005253892798233249,30,7,23
477,477,sc,0.005232019237530788,27,26,1
478,478,jar,0.0052285028289221535,37,32,5
479,479,startswith,0.005222712408652843,50,43,7
480,480,<uri-template>file,0.005219444575357982,21,21,0
481,481,suspend,0.005219444575357981,21,21,0
482,482,optional,0.00521944457535798,21,0,21
483,483,type_,0.00521944457535798,21,21,0
484,484,partition,0.005219444575357979,21,21,0
485,485,replica,0.005219444575357979,21,21,0
486,486,local_a\,0.005219444575357978,21,21,0
487,487,<data-in,0.005219444575357977,21,21,0
488,488,private,0.005219444575357977,21,0,21
489,489,</controls>,0.005219444575357973,21,21,0
490,490,coord-rerun-action1,0.005219444575357973,21,21,0
491,491,queueservice,0.005219444575357973,21,21,0
492,492,filepath,0.0052171552106498684,27,26,1
493,493,ping,0.005196377838145005,21,15,6
494,494,isnotnull,0.005189166016568554,27,26,1
495,495,b,0.005166597430733213,152,94,58
496,496,expect,0.005152559122077535,46,10,36
497,497,all,0.0051395057142524705,209,130,79
498,498,1\,0.00508955419322713,31,29,2
499,499,starts,0.005084043954667066,55,44,11
500,500,timeout,0.005060948702794848,118,47,71
501,501,body,0.004975733359210067,62,38,24
502,502,empty,0.004973714121234152,138,49,89
503,503,/stuff,0.004969608883591125,20,0,20
504,504,</dataset>,0.0049696088835911225,20,20,0
505,505,fork,0.0049696088835911225,20,20,0
506,506,<instance>${coord,0.004969608883591121,20,20,0
507,507,}</instance>,0.004969608883591121,20,20,0
508,508,prepare,0.004968911287391701,45,31,14
509,509,10,0.00495878639838311,63,14,49
510,510,scope,0.004946294270130176,20,13,7
511,511,properties,0.0049332629503751,97,31,66
512,512,adapter,0.004917898044979509,30,10,20
513,513,namespace,0.004911673806642822,23,22,1
514,514,throw,0.004862477336261688,85,32,53
515,515,true,0.004860971710222433,852,474,378
516,516,illegal,0.004841500865781086,29,3,26
517,517,do,0.0048383368035747635,217,75,142
518,518,a,0.004833963696289211,557,297,260
519,519,getresponsecode,0.004829162439275923,48,41,7
520,520,store,0.00477433747221966,70,40,30
521,521,handle,0.0047659998663221416,36,15,21
522,522,contenttype,0.00476315832401899,25,1,24
523,523,example,0.004762585333286483,28,2,26
524,524,/test,0.004748469733321467,39,34,5
525,525,latest,0.004737175336339555,28,26,2
526,526,external,0.0047231120366391845,51,41,10
527,527,nn,0.004719919757961271,21,20,1
528,528,///tmp/workflows/</app-path>,0.004719903146766298,19,19,0
529,529,</data-in>,0.004719903146766298,19,19,0
530,530,</datasets>,0.004719903146766298,19,19,0
531,531,</input-events>,0.004719903146766298,19,19,0
532,532,<datasets>,0.004719903146766298,19,19,0
533,533,<input-events>,0.004719903146766298,19,19,0
534,534,spdy3,0.004719903146766298,19,19,0
535,535,<value>${coord,0.004719903146766293,19,19,0
536,536,deps,0.004719903146766293,19,19,0
537,537,}</value>,0.004719903146766293,19,19,0
538,538,android,0.004719903146766292,19,19,0
539,539,chain,0.004717935448167439,29,3,26
540,540,hadoop,0.004717082939294673,66,38,28
541,541,base,0.004712851402771078,115,82,33
542,542,false,0.004710794893012709,376,184,192
543,543,variable,0.004703724910994803,40,31,9
544,544,thread,0.004655965973830168,200,114,86
545,545,socket,0.0046221491212125355,55,14,41
546,546,password,0.004607503203234757,26,2,24
547,547,pending,0.004603114379730304,48,39,9
548,548,parent,0.00458450795579691,67,49,18
549,549,creation,0.004522715327587691,46,38,8
550,550,flush,0.004515799359340857,80,28,52
551,551,parameter,0.00451475455820653,86,23,63
552,552,windows,0.004499915144251683,22,1,21
553,553,consumer,0.004483506227093922,22,17,5
554,554,evaluator,0.004470327224285909,18,18,0
555,555,}\,0.004470327224285909,18,18,0
556,556,hflush,0.004470327224285908,18,18,0
557,557,abc\,0.004470327224285907,18,18,0
558,558,//hcat,0.004470327224285906,18,18,0
559,559,banana,0.0044703272242859055,18,18,0
560,560,consume,0.0044518937699290365,18,6,12
561,561,complete,0.004436393041214197,42,32,10
562,562,the,0.004417252333939083,629,337,292
563,563,writer,0.004376281143235114,92,57,35
564,564,was,0.004341920119863522,64,48,16
565,565,somehost,0.004336522517520113,23,1,22
566,566,scan,0.004335539036017754,26,22,4
567,567,utc,0.004322017562322527,21,20,1
568,568,corrupt,0.004313303449596509,21,18,3
569,569,lock,0.004300647236208421,43,29,14
570,570,root,0.004299136583797927,59,32,27
571,571,https,0.004257407883350908,30,3,27
572,572,tmp,0.00425331506278166,31,4,27
573,573,admin,0.004241670567692877,29,25,4
574,574,impl,0.004221990087158966,46,8,38
575,575,@1,0.004220880975794962,17,17,0
576,576,advance,0.0042208809757949585,17,0,17
577,577,syn,0.004220880975794958,17,17,0
578,578,dataset,0.004220880975794956,17,17,0
579,579,reduce,0.004220880975794956,17,17,0
580,580,rows,0.004193229783571042,25,23,2
581,581,getheaderfield,0.004188380088903739,31,28,3
582,582,substring,0.004188107405653299,27,24,3
583,583,generictestutils,0.004167254350705859,38,5,33
584,584,expected,0.00415545301429269,300,167,133
585,585,scanner,0.004147809818591684,25,19,6
586,586,aslist,0.004131610072301076,141,98,43
587,587,-1,0.004115731020202004,36,30,6
588,588,events,0.0041085089574581235,27,24,3
589,589,shell,0.004097084610656417,46,17,29
590,590,mapping,0.004086396287995322,33,4,29
591,591,queue,0.004082981680544162,66,45,21
592,592,foo,0.0040800056313457225,93,38,55
593,593,mr,0.004054964204182889,21,20,1
594,594,field,0.004049202001765509,46,33,13
595,595,object,0.004033379437438062,36,12,24
596,596,files,0.004021704552218295,85,51,34
597,597,equal,0.004015862288292184,113,33,80
598,598,of,0.003984604859725832,420,216,204
599,599,_,0.003971576015427818,18,17,1
600,600,<concurrency>2</concurrency>,0.00397156426116942,16,16,0
601,601,<delete,0.00397156426116942,16,16,0
602,602,trx,0.00397156426116942,16,16,0
603,603,wf-app-name1,0.00397156426116942,16,16,0
604,604,column,0.003971564261169418,16,16,0
605,605,t10,0.003971564261169418,16,16,0
606,606,trust,0.003971564261169418,16,0,16
607,607,apply,0.003971564261169417,16,0,16
608,608,tests,0.003971210380636565,40,10,30
609,609,01,0.003964400831964657,16,2,14
610,610,lang,0.003964400831964656,16,2,14
611,611,t,0.0039594810921128746,144,68,76
612,612,future1,0.00395702122428649,21,1,20
613,613,dn,0.003951286450924141,24,21,3
614,614,frame,0.003914539510572532,40,28,12
615,615,exit,0.0038961806237824185,24,7,17
616,616,getmessage,0.0038751054410591235,134,93,41
617,617,no,0.0038445088416924427,227,84,143
618,618,ok,0.0038309084936250888,64,28,36
619,619,begin,0.003811187625634582,32,20,12
620,620,expr,0.0037818430999039653,41,34,7
621,621,locations,0.003781384563046184,24,22,2
622,622,route,0.003777188301817076,30,5,25
623,623,in,0.0037716254195726824,475,263,212
624,624,assertarrayequals,0.0037629644892419748,29,3,26
625,625,validate,0.0037471489579500947,54,38,16
626,626,matrix,0.003747084288808052,19,2,17
627,627,different,0.0037397611865740508,60,18,42
628,628,or,0.0037233844199250138,60,34,26
629,629,</prepare>,0.0037223769405250184,15,15,0
630,630,child2,0.0037223769405250184,15,15,0
631,631,column_1,0.0037223769405250184,15,15,0
632,632,subwf,0.0037223769405250176,15,15,0
633,633,updates,0.0037223769405250176,15,15,0
634,634,ips,0.003715727577566441,15,2,13
635,635,res,0.0036952088656299984,23,12,11
636,636,bytebuffer,0.0036842151864054044,42,7,35
637,637,correct,0.003668065670788986,42,12,30
638,638,rpc,0.003655974002212247,47,21,26
639,639,k,0.0036542096184646114,33,21,12
640,640,version,0.003648137638650408,67,22,45
641,641,anystring,0.0036476326746352405,32,4,28
642,642,failure,0.0036088368759009766,70,37,33
643,643,available,0.003600389657025122,43,22,21
644,644,ex,0.003590080932998445,65,45,20
645,645,entity,0.0035874178222885344,68,29,39
646,646,milliseconds,0.0035847301522436334,27,9,18
647,647,bind,0.003577688699557242,33,5,28
648,648,zk,0.0035680019460424483,24,4,20
649,649,capacity,0.0035265698217736246,19,5,14
650,650,bit,0.003525571391817044,23,3,20
651,651,operation,0.0035139264953322306,25,6,19
652,652,lease,0.0035086436950070464,23,14,9
653,653,arguments,0.003508341877818218,32,5,27
654,654,listener,0.0035023058331386226,61,32,29
655,655,reply,0.0034733368599430938,18,16,2
656,656,</data-out>,0.0034733188742081395,14,14,0
657,657,</output-events>,0.0034733188742081395,14,14,0
658,658,<data-out,0.0034733188742081395,14,14,0
659,659,<output-events>,0.0034733188742081395,14,14,0
660,660,<prepare>,0.0034733188742081395,14,14,0
661,661,<timeout>10</timeout>,0.0034733188742081395,14,14,0
662,662,callables,0.0034733188742081395,14,14,0
663,663,coord-action-for-action-input-check,0.0034733188742081395,14,14,0
664,664,httprocessor,0.0034733188742081395,14,0,14
665,665,material,0.0034733188742081395,14,0,14
666,666,that\,0.0034733188742081395,14,0,14
667,667,pdms,0.003473318874208137,14,14,0
668,668,name\,0.0034727135205363784,27,23,4
669,669,exits,0.0034699953848152778,14,13,1
670,670,custom,0.0034608177188958367,43,8,35
671,671,read,0.0034570085055795527,215,96,119
672,672,value1,0.0034494972890761278,25,3,22
673,673,three,0.003428786147422815,39,31,8
674,674,clear,0.00342786828232905,85,27,58
675,675,unit,0.0034278400224404407,83,33,50
676,676,authenticate,0.0034228518852775108,19,3,16
677,677,async,0.0034150954493057852,33,14,19
678,678,more,0.003414207289372127,97,37,60
679,679,abc,0.003411605915773279,43,33,10
680,680,consistency,0.003411498363308593,22,20,2
681,681,tags,0.003407846710253769,30,21,9
682,682,captor,0.0033910243289329515,18,1,17
683,683,invalid,0.0033904345834542228,62,23,39
684,684,count,0.0033892592206032444,207,120,87
685,685,actual,0.0033838321965851004,50,39,11
686,686,pool,0.0033715657071382863,59,23,36
687,687,2,0.0033601911940107157,219,135,84
688,688,s1,0.0033456042970779684,21,4,17
689,689,generic,0.0033264016944119772,46,9,37
690,690,metric,0.0033181409667990694,25,5,20
691,691,stm,0.0033181287052660878,19,18,1
692,692,14,0.0033152716589374565,17,13,4
693,693,completed,0.0033131360696120014,50,13,37
694,694,input,0.0033059926367004517,153,73,80
695,695,success,0.0033031902873683697,46,34,12
696,696,filter,0.003302120753033127,98,39,59
697,697,java,0.0032975626194794347,48,23,25
698,698,original,0.0032867754060817,23,17,6
699,699,setup,0.0032823316899208213,124,58,66
700,700,entry,0.003263367497529562,52,13,39
701,701,names,0.003254440651405707,70,24,46
702,702,key1,0.0032345911129979675,18,2,16
703,703,factor,0.003224397665726824,15,14,1
704,704,requester,0.003224389922801857,13,0,13
705,705,2009-03-06,0.003224389922801855,13,13,0
706,706,job3,0.003224389922801855,13,13,0
707,707,regions,0.003224389922801855,13,13,0
708,708,signer,0.0032243899228018543,13,0,13
709,709,</property></configuration>,0.0032243899228018534,13,13,0
710,710,<mkdir,0.0032243899228018534,13,13,0
711,711,callable1,0.0032243899228018534,13,13,0
712,712,callable2,0.0032243899228018534,13,13,0
713,713,callable3,0.0032243899228018534,13,13,0
714,714,coord-action-start,0.0032243899228018534,13,13,0
715,715,kills,0.0032243899228018534,13,13,0
716,716,but,0.003221805376745018,85,55,30
717,717,i,0.003219036156258774,53,38,15
718,718,mtime,0.0032187675821728472,13,2,11
719,719,value,0.003180629044636425,339,151,188
720,720,testfile,0.0031641776793442603,32,7,25
721,721,retries,0.003162230760390254,22,5,17
722,722,hello,0.0031620488746595,21,2,19
723,723,file2,0.0031537690922326415,30,22,8
724,724,writable,0.0031401692867020024,26,4,22
725,725,timestamp,0.003136927895009699,24,19,5
726,726,capture,0.0031367743940019554,26,3,23
727,727,p1,0.003131928305661966,18,1,17
728,728,public,0.0031292827008110435,31,5,26
729,729,string,0.003117168182039304,585,297,288
730,730,arrays,0.0031126933827014683,156,100,56
731,731,principal,0.0031109531809061044,25,4,21
732,732,post,0.0031075553438337416,34,19,15
733,733,class,0.003093598578653327,126,44,82
734,734,without,0.00309242879111283,55,16,39
735,735,storage,0.003088957362008393,37,25,12
736,736,never,0.003087868341543986,38,9,29
737,737,meta,0.003058541629561066,21,17,4
738,738,missing,0.003057675864303439,78,52,26
739,739,works,0.003057047086158891,48,13,35
740,740,consumed,0.0030482220225475074,19,5,14
741,741,setstatus,0.0030478682063870156,29,25,4
742,742,fake,0.0030325245334668002,24,7,17
743,743,proto,0.0029967351533647657,31,26,5
744,744,scheme,0.002991572848624229,30,11,19
745,745,ds,0.002990799643980918,21,19,2
746,746,modified,0.0029893958412553472,33,25,8
747,747,params,0.002986459346591537,41,33,8
748,748,headers,0.0029847801355095084,97,47,50
749,749,directory,0.0029803711315151927,86,39,47
750,750,model,0.0029755965399080432,14,13,1
751,751,transfer,0.0029755965399080424,14,1,13
752,752,bootstrap,0.0029755899471226154,12,0,12
753,753,country=usa,0.0029755899471226145,12,12,0
754,754,renderable,0.0029755899471226145,12,0,12
755,755,action4,0.0029755899471226137,12,12,0
756,756,consistencylist,0.0029755899471226137,12,12,0
757,757,country=brazil,0.0029755899471226137,12,12,0
758,758,elector,0.0029755899471226137,12,0,12
759,759,testfile01,0.0029755899471226137,12,0,12
760,760,testfile02,0.0029755899471226137,12,0,12
761,761,testfile03,0.0029755899471226137,12,0,12
762,762,testfile04,0.0029755899471226137,12,0,12
763,763,testfile05,0.0029755899471226137,12,0,12
764,764,testfile06,0.0029755899471226137,12,0,12
765,765,data-in,0.002975589947122613,12,12,0
766,766,png,0.0029727797840454883,12,1,11
767,767,a2,0.0029727797840454874,12,11,1
768,768,edit,0.0029727797840454866,12,11,1
769,769,fault,0.002970480563642698,12,10,2
770,770,warning,0.002970480563642698,12,2,10
771,771,fails,0.0029696280227268657,38,19,19
772,772,injection,0.002968692283554243,12,9,3
773,773,aa,0.002968692283554242,12,9,3
774,774,tokens,0.0029686032196045023,20,3,17
775,775,callable,0.002968594207355,18,16,2
776,776,v,0.0029685942073549984,18,2,16
777,777,work,0.002967916771449806,40,9,31
778,778,ip,0.002961474201437675,33,8,25
779,779,deprecation,0.0029594887303101597,17,1,16
780,780,state,0.002941642080954764,70,40,30
781,781,order,0.002927447736623748,54,24,30
782,782,report,0.0029196413546057373,26,22,4
783,783,q,0.0029109802029034255,15,3,12
784,784,user1,0.002892281843052645,33,22,11
785,785,it,0.0028918680858509233,159,99,60
786,786,an,0.002879461770894135,111,42,69
787,787,void_keyword,0.002857183131205627,2804,1402,1402
788,788,@,0.0028546735371114866,31,20,11
789,789,auth,0.0028514821932356564,57,27,30
790,790,obj,0.0028355442319443077,16,8,8
791,791,com,0.00282334582524156,70,34,36
792,792,tostring,0.0028159580212094876,375,219,156
793,793,w,0.002807405808860159,31,26,5
794,794,exists,0.002801161044733406,137,88,49
795,795,received,0.0027969961979645115,48,35,13
796,796,debug,0.002796193576343093,21,15,6
797,797,host,0.002795163914165254,75,25,50
798,798,sink,0.002789028541414226,26,7,19
799,799,xx,0.00278898878535578,14,1,13
800,800,encoded,0.002788988785355779,14,1,13
801,801,servlet,0.0027688461694015945,107,57,50
802,802,because,0.0027597600555935467,39,31,8
803,803,d,0.0027592147094237943,46,17,29
804,804,desc,0.0027553548305201438,20,11,9
805,805,resume,0.0027516165742861903,15,13,2
806,806,protocol,0.002750577753327192,40,9,31
807,807,strategy,0.0027393999915728364,28,8,20
808,808,link,0.0027269298877519678,15,2,13
809,809,heartbeat,0.002726918808223064,11,11,0
810,810,/dt=20120430,0.002726918808223063,11,11,0
811,811,action5,0.002726918808223063,11,11,0
812,812,racks,0.002726918808223063,11,11,0
813,813,records,0.0027235989481192973,34,25,9
814,814,host2,0.0027223220132555582,11,2,9
815,815,c1,0.002708913820900243,17,8,9
816,816,rm,0.0026918993935368877,15,13,2
817,817,regex,0.002677532468665602,18,2,16
818,818,mask,0.002677532468665601,18,2,16
819,819,initial,0.002663454320319599,31,16,15
820,820,include,0.002659624584116103,14,9,5
821,821,every,0.0026574733524920287,16,1,15
822,822,exist,0.002650377686222286,48,19,29
823,823,p,0.0026285566783518953,56,20,36
824,824,iscompleted,0.002621140452496515,30,5,25
825,825,proxy,0.002610236917988485,71,31,40
826,826,kerberos,0.0026088232390540107,17,2,15
827,827,found,0.0026058900723748488,64,30,34
828,828,after,0.002603980801148844,105,67,38
829,829,warn,0.002596086601942909,17,14,3
830,830,safe,0.0025935273272626176,17,13,4
831,831,authenticated,0.0025935236108520503,15,3,12
832,832,answer,0.002592093090434806,19,4,15
833,833,need,0.00258981265392121,18,10,8
834,834,called,0.0025815412649137703,39,11,28
835,835,5,0.0025677855027171747,70,30,40
836,836,setboolean,0.0025648913770933562,58,43,15
837,837,delegation,0.0025602484687914815,28,6,22
838,838,management,0.0025594421119484435,15,1,14
839,839,subject,0.002540316589465234,13,1,12
840,840,proxyuser,0.0025357232450529043,19,13,6
841,841,a1,0.0025357165004616295,13,10,3
842,842,buf,0.0025300901264003876,29,5,24
843,843,remove,0.002526310769021059,77,29,48
844,844,space,0.0025079631874946207,17,8,9
845,845,temp,0.00250079186593814,32,6,26
846,846,parameters,0.0024962281918325295,39,15,24
847,847,permission,0.002492211993853438,38,23,15
848,848,split,0.0024912608279115925,17,15,2
849,849,elements,0.0024874110219706164,26,5,21
850,850,double,0.0024783946937875032,18,4,14
851,851,credentials,0.0024783855174489253,14,2,12
852,852,cell,0.002478380939138252,12,11,1
853,853,222,0.002478376367383445,10,0,10
854,854,103,0.002478376367383444,10,0,10
855,855,feature,0.002478376367383443,10,10,0
856,856,mapfile,0.002478376367383443,10,0,10
857,857,edits,0.0024783763673834423,10,10,0
858,858,host4,0.0024783763673834423,10,0,10
859,859,lot,0.0024783763673834423,10,0,10
860,860,4\,0.0024760787928186185,10,9,1
861,861,usage,0.0024760787928186185,10,1,9
862,862,alternate,0.002476078792818617,10,1,9
863,863,due,0.0024743673919047473,27,21,6
864,864,quota,0.0024722496925958324,12,7,5
865,865,c2,0.002472249509726779,10,6,4
866,866,compute,0.002471912590608082,21,3,18
867,867,short_keyword,0.0024719022374611313,19,17,2
868,868,invocation,0.002470860489562089,16,2,14
869,869,our,0.002470860489562089,16,2,14
870,870,first,0.0024702610943752802,150,77,73
871,871,am,0.002468364318160462,18,15,3
872,872,deleted,0.002466636442812317,28,16,12
873,873,os,0.0024618992902841353,24,20,4
874,874,hours,0.002461650416855323,16,8,8
875,875,once,0.0024563506305179685,28,6,22
876,876,ms,0.002454542558776692,40,10,30
877,877,currenttimemillis,0.0024452743109212513,65,47,18
878,878,size,0.002443338872109824,397,222,175
879,879,be,0.0024305595966871182,303,166,137
880,880,connect,0.0024269345808235225,56,17,39
881,881,integer,0.0024258711022584825,66,36,30
882,882,echo,0.0024191332536625263,13,1,12
883,883,mockfs,0.0024165776469106393,13,2,11
884,884,on,0.0024124354102673046,193,114,79
885,885,domain,0.0024119775657805717,13,5,8
886,886,supported,0.002411977565780571,13,5,8
887,887,acl,0.0024106661029410508,18,5,13
888,888,enters,0.002408543157595712,15,14,1
889,889,group,0.002404627813736114,145,70,75
890,890,flag,0.0023986923782230553,19,11,8
891,891,with,0.002393769902069141,612,312,300
892,892,checksum,0.002386866191866722,20,12,8
893,893,total,0.0023841989222363955,32,13,19
894,894,throw_keyword,0.0023833570987319445,85,54,31
895,895,can,0.002365497125943367,52,20,32
896,896,settings,0.0023530765015539867,20,6,14
897,897,element,0.0023529411739624624,25,14,11
898,898,boolean,0.0023512433154363258,108,56,52
899,899,compression,0.0023503488575016955,14,1,13
900,900,callback,0.0023450477372429102,24,7,17
901,901,now,0.0023366975975067754,122,53,69
902,902,getinstance,0.0023325899995368044,31,6,25
903,903,results,0.0023257160510191327,34,10,24
904,904,attempt,0.002322647699818558,17,14,3
905,905,attribute,0.0023106475883718047,16,2,14
906,906,ugi,0.0023104343005881517,52,16,36
907,907,type,0.0023063392463587,217,102,115
908,908,yarn,0.002291777762896662,14,12,2
909,909,remaining,0.0022908402496065947,25,4,21
910,910,h2,0.0022849811030179286,17,2,15
911,911,bad,0.0022799551289987693,54,22,32
912,912,new,0.00227854315022529,345,176,169
913,913,address,0.0022727769139082605,92,35,57
914,914,pattern,0.0022660272306570485,35,11,24
915,915,children,0.0022613884232396617,16,13,3
916,916,failed,0.0022607020136772675,94,51,43
917,917,entries,0.002260402897295328,41,21,20
918,918,millis,0.002259969849768129,84,55,29
919,919,injector,0.0022544493343945073,16,4,12
920,920,raw,0.0022314365839339947,27,5,22
921,921,multiple,0.002230671463600999,68,32,36
922,922,push,0.002229969892358374,13,11,2
923,923,serial,0.002229969892358374,13,11,2
924,924,221,0.0022299624861205295,9,0,9
925,925,election,0.0022299624861205295,9,0,9
926,926,jetty,0.0022299624861205295,9,0,9
927,927,jwt,0.0022299624861205295,9,0,9
928,928,p12,0.0022299624861205295,9,0,9
929,929,119,0.0022299624861205286,9,0,9
930,930,region=us,0.0022299624861205286,9,9,0
931,931,flash,0.0022279209297983663,9,1,8
932,932,stop,0.0022264322435162345,129,54,75
933,933,streaming,0.0022263897643860714,9,7,2
934,934,authorization,0.002226367118543066,20,5,15
935,935,gz,0.002224858600542024,9,4,5
936,936,catch,0.0022228414951303965,18,16,2
937,937,passed,0.002219690003729351,17,3,14
938,938,try,0.002217851221255153,47,16,31
939,939,delay,0.0022150833124678967,17,12,5
940,940,join,0.0022107069056548686,96,61,35
941,941,ascii,0.002204171260272587,21,10,11
942,942,task,0.002200684363493263,19,11,8
943,943,keys,0.0021957527932103408,147,73,74
944,944,are,0.00219476966305071,129,71,58
945,945,four,0.0021869729186075586,21,17,4
946,946,hosts,0.0021766720979235765,33,23,10
947,947,usergroupinformation,0.0021761560094074534,72,22,50
948,948,duration,0.0021709938978412098,29,8,21
949,949,send,0.00215376776931044,74,42,32
950,950,contents,0.0021525139898834807,26,6,20
951,951,org,0.002151935285233089,41,27,14
952,952,details,0.002150519106034697,19,3,16
953,953,load,0.0021496679188573063,25,9,16
954,954,cookies,0.0021272188111486354,23,5,18
955,955,has,0.002122944772776445,171,78,93
956,956,configuration,0.002113135442008668,181,78,103
957,957,pair,0.0021124223575591686,21,6,15
958,958,httpservletresponse,0.002109243565186738,65,46,19
959,959,prefix,0.002106618343224722,29,14,15
960,960,information,0.0021040598064056746,81,27,54
961,961,rs,0.002094520973729195,13,8,5
962,962,kind,0.002087260365300346,16,2,14
963,963,number,0.0020855469048135598,93,41,52
964,964,instanceof_keyword,0.002084438142559185,70,29,41
965,965,interrupted,0.0020781824532093134,14,3,11
966,966,index,0.0020759803869241826,49,30,19
967,967,final,0.00207060997482669,15,2,13
968,968,access,0.0020701486904678977,18,4,14
969,969,excluded,0.0020580697225056864,24,17,7
970,970,j,0.0020572458272583643,50,35,15
971,971,s,0.0020557352480968026,62,22,40
972,972,2\,0.0020533778618776356,23,19,4
973,973,while,0.0020518862870561477,29,17,12
974,974,dst,0.0020467205460783944,27,8,19
975,975,started,0.0020448698654298146,24,5,19
976,976,interval,0.0020437686458240536,42,16,26
977,977,rack,0.0020413199005270455,15,11,4
978,978,image,0.002038761644925243,11,7,4
979,979,handler,0.0020353338291348,96,39,57
980,980,master,0.002030978341040206,17,12,5
981,981,extends_keyword,0.002030706598023878,19,3,16
982,982,that,0.0020288621359244477,391,180,211
983,983,/,0.002025810100212372,154,92,62
984,984,ca,0.002025528361453514,28,22,6
985,985,encoding,0.0020237013167105126,19,5,14
986,986,initialize,0.002023693878550258,15,3,12
987,987,pass,0.002018956055748175,30,19,11
988,988,real,0.002017585256535199,43,13,30
989,989,refresh,0.002015645005020023,44,13,31
990,990,util,0.002007549401394218,144,82,62
991,991,last,0.002003597410928242,87,55,32
992,992,13,0.0020032204890259465,15,8,7
993,993,simulated,0.0020014167791118707,18,15,3
994,994,fill,0.002001100582506396,22,4,18
995,995,h1,0.001991224145413246,13,2,11
996,996,compare,0.0019883338186627722,29,12,17
997,997,timeunit,0.001985117215792538,64,31,33
998,998,dataname,0.0019816770261812475,8,8,0
999,999,113,0.0019816770261812467,8,0,8
1000,1000,batch,0.0019816770261812467,8,8,0
1001,1001,description,0.0019816770261812467,8,0,8
1002,1002,realm,0.0019816770261812467,8,0,8
1003,1003,-3,0.001981677026181246,8,8,0
1004,1004,encrypted,0.001981677026181246,8,0,8
1005,1005,keytab,0.001981677026181246,8,0,8
1006,1006,naming,0.001981677026181246,8,8,0
1007,1007,mapred,0.0019798929479145156,10,8,2
1008,1008,distributed,0.0019786165206532947,10,7,3
1009,1009,exclude,0.001977850847688596,12,7,5
1010,1010,old,0.0019768259582222825,29,15,14
1011,1011,contain,0.0019758734112167524,19,15,4
1012,1012,signal,0.001973958861530279,16,14,2
1013,1013,back,0.0019718407721086746,71,46,25
1014,1014,ce,0.0019640258103427173,13,12,1
1015,1015,future2,0.0019640258103427173,13,1,12
1016,1016,disable,0.0019542935029118217,18,15,3
1017,1017,gauge,0.001948951600015935,12,1,11
1018,1018,option,0.0019303047425229432,24,10,14
1019,1019,mapreduce,0.0019221750962328792,11,10,1
1020,1020,language,0.0019186009598994832,13,4,9
1021,1021,previous,0.0019185998161475011,11,8,3
1022,1022,http/1,0.0019114590778231228,17,3,14
1023,1023,basic,0.0019078569466030627,45,17,28
1024,1024,f2,0.001879291240241175,19,15,4
1025,1025,7,0.0018743353094637406,31,20,11
1026,1026,character,0.0018628033367389784,14,2,12
1027,1027,addr,0.0018558339866044712,55,25,30
1028,1028,this,0.0018458521030367964,141,71,70
1029,1029,max,0.0018457889093994049,70,29,41
1030,1030,appender,0.0018403737667400462,19,6,13
1031,1031,stats,0.001829468751501786,27,14,13
1032,1032,user_,0.0018197824051903845,26,9,17
1033,1033,security,0.0018099644153447038,23,6,17
1034,1034,bar,0.001802424512099699,49,23,26
1035,1035,allowed,0.0018003517456372411,33,14,19
1036,1036,machine,0.001795072193359119,10,1,9
1037,1037,ops,0.0017920094975779097,12,4,8
1038,1038,always,0.001790987625076684,16,8,8
1039,1039,returned,0.0017877601747939543,27,11,16
1040,1040,internal,0.001784541503522571,18,4,14
1041,1041,negative,0.0017605937005430918,24,12,12
1042,1042,12345,0.0017602540282148364,11,1,10
1043,1043,str,0.001752302848138871,67,43,24
1044,1044,je,0.0017521588700464543,19,16,3
1045,1045,alive,0.001750274020855036,22,6,16
1046,1046,executors,0.0017496416995039267,28,6,22
1047,1047,dummy,0.0017493317150326301,60,40,20
1048,1048,trigger,0.0017419175152588095,24,10,14
1049,1049,local,0.001735008325609693,128,62,66
1050,1050,monitor,0.0017335243234410857,11,2,9
1051,1051,standby,0.0017335243234410857,11,2,9
1052,1052,to=\,0.0017335198495436119,7,7,0
1053,1053,fsimage,0.001733519849543611,7,7,0
1054,1054,jks,0.001733519849543611,7,0,7
1055,1055,relogin,0.001733519849543611,7,0,7
1056,1056,simplemap,0.001733519849543611,7,7,0
1057,1057,simpleset,0.001733519849543611,7,7,0
1058,1058,with_,0.001733519849543611,7,0,7
1059,1059,items,0.00173250891479974,24,9,15
1060,1060,renew,0.0017319909194788352,9,2,7
1061,1061,container,0.0017319897789972926,7,6,1
1062,1062,archive,0.0017309697328359228,7,5,2
1063,1063,21,0.0017309697328359219,7,2,5
1064,1064,owner,0.0017278690273849415,20,7,13
1065,1065,ac,0.0017201160393892313,13,6,7
1066,1066,what,0.0017151315058769028,32,22,10
1067,1067,sync,0.0017073088112413053,17,11,6
1068,1068,before,0.0017040990521775658,56,35,21
1069,1069,sec,0.0017003391900165983,20,6,14
1070,1070,up,0.0017000917808729773,79,52,27
1071,1071,timer,0.0016991811215600755,19,6,13
1072,1072,full,0.0016963281028414576,46,24,22
1073,1073,sequence,0.0016912272669187276,21,6,15
1074,1074,mapper,0.001690519715069721,48,34,14
1075,1075,for_keyword,0.0016877925648201104,357,187,170
1076,1076,values,0.0016796333999284123,88,40,48
1077,1077,output,0.0016711344369139398,100,51,49
1078,1078,execution,0.0016704775145752024,26,12,14
1079,1079,seed,0.0016700595744645712,10,6,4
1080,1080,user2,0.001665547372844369,17,10,7
1081,1081,nothing,0.001662913740707506,16,3,13
1082,1082,retry,0.0016572362119550784,42,16,26
1083,1083,reference,0.0016567738811598893,18,10,8
1084,1084,hash,0.001650870194019207,33,17,16
1085,1085,seek,0.001640859861037298,13,8,5
1086,1086,keep,0.001637754613887796,16,5,11
1087,1087,allocate,0.0016199625487474754,30,7,23
1088,1088,props,0.0016119683464960273,34,10,24
1089,1089,must,0.0016073326181706123,37,12,25
1090,1090,setting,0.0016067449135271908,30,19,11
1091,1091,attributes,0.0016046353385840706,12,5,7
1092,1092,ipc,0.0016026799726729618,15,11,4
1093,1093,localfs,0.0015998375882969877,16,4,12
1094,1094,ids,0.001595739914489577,22,13,9
1095,1095,txt,0.0015886773482391273,50,19,31
1096,1096,assertnotsame,0.0015882375323596747,27,21,6
1097,1097,since,0.0015856989125684392,36,19,17
1098,1098,unreliable,0.0015837777522726372,10,1,9
1099,1099,super,0.0015787256087318943,23,8,15
1100,1100,based,0.0015752791424182523,35,11,24
1101,1101,location,0.0015735647657535096,30,16,14
1102,1102,login,0.0015716568550415938,22,8,14
1103,1103,static,0.0015700778807656813,23,9,14
1104,1104,same,0.0015672884726964922,119,60,59
1105,1105,authority,0.0015629856390444665,27,10,17
1106,1106,if,0.0015580403422371892,103,51,52
1107,1107,something,0.0015560298360590575,16,10,6
1108,1108,src,0.0015527260915801002,24,8,16
1109,1109,release,0.0015509234663157092,16,5,11
1110,1110,move,0.0015469165688888225,11,9,2
1111,1111,43,0.001545383164926572,9,7,2
1112,1112,main,0.0015453467446876067,14,12,2
1113,1113,change,0.0015332354459567134,45,24,21
1114,1114,value2,0.0015332288525257724,17,3,14
1115,1115,such,0.0015325699077910404,14,7,7
1116,1116,mkdir,0.0015235684624926634,21,15,6
1117,1117,classpath,0.0015196761134837885,11,7,4
1118,1118,resolved,0.0015119765798815997,16,12,4
1119,1119,loaded,0.001506183323404471,15,4,11
1120,1120,replace,0.0015046592469075233,33,19,14
1121,1121,changed,0.001502564646938205,17,5,12
1122,1122,unknown,0.0015021621816712406,19,4,15
1123,1123,policy,0.0015005351946051088,34,14,20
1124,1124,restart,0.0014906083621721911,24,14,10
1125,1125,enable,0.0014892498232351261,15,12,3
1126,1126,blocked,0.0014854941030072785,10,2,8
1127,1127,drwho,0.001485490818415293,6,0,6
1128,1128,121,0.001485490818415292,6,0,6
1129,1129,958,0.001485490818415292,6,6,0
1130,1130,vevent,0.001485490818415292,6,0,6
1131,1131,2009-06-24,0.0014854908184152912,6,6,0
1132,1132,323,0.0014854908184152912,6,6,0
1133,1133,country=us,0.0014854908184152912,6,6,0
1134,1134,oryx,0.0014854908184152912,6,6,0
1135,1135,corrupted,0.0014842169453153971,8,6,2
1136,1136,end\,0.0014842162159286795,6,5,1
1137,1137,validator,0.0014834518199123067,10,6,4
1138,1138,instances,0.0014834516373050995,8,5,3
1139,1139,limit,0.0014815056490506961,23,15,8
1140,1140,reverse,0.0014789097319648334,17,4,13
1141,1141,6,0.001478012318528404,40,14,26
1142,1142,dirs,0.0014651514104148111,18,8,10
1143,1143,support,0.0014614752906692997,28,21,7
1144,1144,asserttrue,0.0014612906463614128,784,426,358
1145,1145,roll,0.001457063517560473,26,13,13
1146,1146,least,0.0014552137972912924,24,8,16
1147,1147,superuser,0.0014548077866545503,20,9,11
1148,1148,got,0.001443243711273458,35,19,16
1149,1149,writefile,0.0014420515078513857,42,30,12
1150,1150,some,0.0014418600431957821,84,37,47
1151,1151,we,0.001435867333225576,110,49,61
1152,1152,int,0.0014344855771103583,164,70,94
1153,1153,charset,0.0014341655010808793,13,2,11
1154,1154,3,0.001433447646177503,147,82,65
1155,1155,could,0.001430740484879919,26,20,6
1156,1156,application,0.001430357786591811,21,16,5
1157,1157,dir1,0.001430357786591811,21,16,5
1158,1158,become,0.0014257377198171016,15,4,11
1159,1159,half,0.0014257309945361583,9,8,1
1160,1160,filters,0.0014231790530538592,9,3,6
1161,1161,de,0.0014218625402840253,14,3,11
1162,1162,minutes,0.001418794720999806,14,5,9
1163,1163,calendar,0.0014177721159730388,14,7,7
1164,1164,tobytearray,0.0014136493448858936,34,9,25
1165,1165,helper,0.0014013040616915745,39,11,28
1166,1166,test2,0.001401128261416515,10,1,9
1167,1167,maps,0.0014002425139731153,20,11,9
1168,1168,modify,0.0013917686705415605,18,12,6
1169,1169,fixed,0.0013825529300291114,27,8,19
1170,1170,ret,0.0013799485377313774,29,18,11
1171,1171,operations,0.0013690873826936803,16,13,3
1172,1172,down,0.001367528872196674,57,32,25
1173,1173,target,0.0013646165049644226,54,22,32
1174,1174,attempts,0.0013622686669786527,12,7,5
1175,1175,valid,0.0013615036157999336,36,12,24
1176,1176,put,0.0013593303330961424,160,76,84
1177,1177,op,0.0013577562824893894,17,10,7
1178,1178,latch,0.0013537472643038615,24,17,7
1179,1179,blah,0.0013444382585020057,19,7,12
1180,1180,sent,0.0013423124732052736,17,6,11
1181,1181,future,0.0013394598149731505,38,14,24
1182,1182,only,0.0013341464220757862,83,49,34
1183,1183,during,0.001333068358931524,11,7,4
1184,1184,requests,0.0013330679477700858,9,3,6
1185,1185,single,0.0013307692672737915,58,30,28
1186,1186,source,0.0013269827047048153,46,23,23
1187,1187,real_,0.0013167390657548637,20,6,14
1188,1188,done,0.0013141088033611532,43,29,14
1189,1189,includes,0.001310939927999106,15,4,11
1190,1190,parsing,0.0013104445284703855,27,7,20
1191,1191,via,0.001307188606092914,18,8,10
1192,1192,summary,0.0013052784899180714,18,12,6
1193,1193,by,0.0013051775747005105,130,52,78
1194,1194,await,0.001304231186340747,51,26,25
1195,1195,#,0.0013019969525042184,15,9,6
1196,1196,avg,0.001298886348455016,10,2,8
1197,1197,crc,0.0012976099211937952,10,3,7
1198,1198,02,0.001297609190763134,8,6,2
1199,1199,succeed,0.0012969422688428548,19,14,5
1200,1200,\%s,0.0012968438827528372,8,3,5
1201,1201,stat,0.0012838327154539543,21,7,14
1202,1202,other,0.001283427918573183,42,16,26
1203,1203,multi,0.0012812697702436716,21,9,12
1204,1204,generate,0.001279216838945661,44,21,23
1205,1205,f1,0.00127527831332432,20,14,6
1206,1206,working,0.0012742029559317507,14,10,4
1207,1207,scheduler,0.0012729246986628844,14,5,9
1208,1208,assertthat,0.001271299702816725,185,75,110
1209,1209,override,0.001270282349834246,12,2,10
1210,1210,sets,0.0012664503236946185,12,7,5
1211,1211,/foo/bar,0.0012638099265181147,9,1,8
1212,1212,hostname,0.0012618137540140175,12,7,5
1213,1213,&,0.0012545326361382636,16,5,11
1214,1214,threads,0.0012535319533190968,34,14,20
1215,1215,testing,0.001251188327248312,118,68,50
1216,1216,strings,0.0012447802185897071,28,16,12
1217,1217,g,0.001243488670597222,24,8,16
1218,1218,second,0.0012427858806374537,55,23,32
1219,1219,specified,0.001239640103289326,24,11,13
1220,1220,proxy_,0.0012375989518871502,21,8,13
1221,1221,page,0.0012375932166880012,11,8,3
1222,1222,counters,0.0012375920745715998,9,7,2
1223,1223,ticket,0.0012375909340900564,7,1,6
1224,1224,class_keyword,0.0012375897952383221,5,0,5
1225,1225,requires_keyword,0.0012375897952383221,5,5,0
1226,1226,\%d,0.0012375897952383221,5,0,5
1227,1227,317,0.0012375897952383213,5,5,0
1228,1228,<chmod,0.0012375897952383213,5,5,0
1229,1229,action-actual-time=\,0.0012375897952383213,5,5,0
1230,1230,har,0.0012375897952383213,5,0,5
1231,1231,permissions=\,0.0012375897952383213,5,5,0
1232,1232,xxx,0.0012375897952383213,5,0,5
1233,1233,xxxx,0.0012375897952383213,5,0,5
1234,1234,function,0.0012365717096630342,11,7,4
1235,1235,window,0.0012365712985015946,9,6,3
1236,1236,104,0.001236570477942363,5,1,4
1237,1237,mail,0.001236570477942363,5,1,4
1238,1238,rolling,0.0012360608651090415,7,3,4
1239,1239,ioexception,0.0012314046083367492,23,7,16
1240,1240,my,0.0012296155342765868,40,20,20
1241,1241,messages,0.0012283256117384686,13,2,11
1242,1242,min,0.0012273102928127065,25,9,16
1243,1243,match,0.0012256217947224412,36,14,22
1244,1244,geturi,0.0012240686413599287,30,22,8
1245,1245,counter,0.001223974435675802,32,18,14
1246,1246,added,0.0012127241846606272,23,6,17
1247,1247,expired,0.001210568099197549,14,3,11
1248,1248,under,0.0012075582010691983,21,6,15
1249,1249,calls,0.001206525571033722,19,7,12
1250,1250,created,0.0012052797166526704,55,35,20
1251,1251,format,0.0012019437863047392,97,42,55
1252,1252,cleanup,0.001194791729737089,40,25,15
1253,1253,char,0.0011842176953752188,54,33,21
1254,1254,bb,0.0011828128608526783,12,8,4
1255,1255,rename,0.0011817909883514565,20,10,10
1256,1256,n,0.0011809807594684377,29,15,14
1257,1257,types,0.0011713257214398323,20,7,13
1258,1258,+,0.001169853959977216,30,19,11
1259,1259,html,0.0011662123766357146,16,4,12
1260,1260,will,0.0011617557602408854,85,52,33
1261,1261,at,0.0011585323688147846,72,31,41
1262,1262,sure,0.0011523115311092387,76,40,36
1263,1263,query,0.0011443332138486922,32,16,16
1264,1264,text,0.0011440234773820684,37,18,19
1265,1265,net,0.0011426186648994842,32,9,23
1266,1266,netutils,0.0011426186648994842,32,9,23
1267,1267,like,0.0011381562378885,15,10,5
1268,1268,non,0.0011334490932443323,38,17,21
1269,1269,users,0.00112731301169652,26,10,16
1270,1270,4,0.0011248565822479153,89,41,48
1271,1271,setint,0.0011239370731092324,66,43,23
1272,1272,while_keyword,0.0011185219318080196,78,41,37
1273,1273,go,0.0011165025470282405,17,5,12
1274,1274,file_,0.0011150420008747618,33,21,12
1275,1275,timed,0.001114877620609963,11,6,5
1276,1276,starting,0.0011139432802560675,17,10,7
1277,1277,there,0.001113733445008003,40,26,14
1278,1278,force,0.0011134314274287788,17,9,8
1279,1279,p2,0.0011053160763480896,17,4,13
1280,1280,absolute,0.0010983909050268715,34,13,21
1281,1281,directories,0.0010895497966046707,22,12,10
1282,1282,b\,0.0010875952013794888,14,10,4
1283,1283,exceptions,0.001086316211584192,12,4,8
1284,1284,gzip,0.0010863154801073124,10,3,7
1285,1285,runtime,0.0010855501736675931,16,9,7
1286,1286,cancel,0.001085549990275124,14,6,8
1287,1287,snapshot,0.0010855496242735616,10,4,6
1288,1288,cached,0.0010818879633792268,14,10,4
1289,1289,reset,0.0010798834062796555,95,53,42
1290,1290,period,0.0010752256200840058,31,13,18
1291,1291,ls,0.0010749521485201282,38,17,21
1292,1292,cause,0.0010596149077625136,46,17,29
1293,1293,ldap,0.0010509831795377932,7,1,6
1294,1294,closest,0.0010494531105567782,7,4,3
1295,1295,gc,0.0010494531105567782,7,3,4
1296,1296,resolve,0.001048479010839121,39,19,20
1297,1297,incorrect,0.0010465108125917422,21,11,10
1298,1298,localhost,0.0010453150689824315,72,36,36
1299,1299,group1,0.0010381770868865617,13,3,10
1300,1300,host1,0.00103664372703436,13,4,9
1301,1301,ignored,0.00103664372703436,13,4,9
1302,1302,each,0.0010295311068480653,22,13,9
1303,1303,expecting,0.0010252768574151132,9,6,3
1304,1304,good,0.0010247772766379367,24,11,13
1305,1305,/bar,0.001020591537601259,11,3,8
1306,1306,getcurrentuser,0.0010194216813326643,30,9,21
1307,1307,offset,0.0010188925486834637,15,9,6
1308,1308,make,0.0010167070609201447,148,70,78
1309,1309,testdir,0.0010165932834079053,30,10,20
1310,1310,do_keyword,0.0010145047869423826,8,6,2
1311,1311,required,0.0010087155153952528,13,7,6
1312,1312,methods,0.0009898232354760318,22,9,13
1313,1313,health,0.0009898188308388226,10,3,7
1314,1314,trash,0.0009898173710214432,6,1,5
1315,1315,minute\,0.0009898166426772258,4,4,0
1316,1316,/b,0.000989816642677225,4,4,0
1317,1317,articles,0.000989816642677225,4,4,0
1318,1318,eek,0.000989816642677225,4,0,4
1319,1319,month=12,0.000989816642677225,4,4,0
1320,1320,token-,0.000989816642677225,4,4,0
1321,1321,extra,0.0009890533410066328,14,6,8
1322,1322,umask,0.000989052610050726,6,2,4
1323,1323,{\,0.0009887976898144725,12,6,6
1324,1324,correctly,0.0009847196245620113,22,8,14
1325,1325,127,0.0009845403604528445,15,6,9
1326,1326,ext,0.0009840288746770006,15,7,8
1327,1327,11,0.000980751450419183,10,2,8
1328,1328,g1,0.000980751450419183,10,2,8
1329,1329,200,0.0009722034330784217,16,4,12
1330,1330,here,0.0009704712255222993,21,15,6
1331,1331,port,0.0009687822791151152,91,37,54
1332,1332,use,0.000964395653358621,46,21,25
1333,1333,y,0.0009624941895918712,14,3,11
1334,1334,logger,0.0009607112440122509,22,8,14
1335,1335,matches,0.0009592680519008548,20,6,14
1336,1336,getclass,0.0009566723450409979,28,8,20
1337,1337,item,0.0009560278096381039,17,5,12
1338,1338,range,0.0009464332745004514,28,18,10
1339,1339,interrupt,0.00093299405853147,28,14,14
1340,1340,double_keyword,0.0009297998437350855,7,1,6
1341,1341,50,0.0009287802081466229,9,3,6
1342,1342,closed,0.0009258396511822075,19,11,8
1343,1343,8,0.0009096837640570933,18,5,13
1344,1344,configure,0.0008965733777396801,30,21,9
1345,1345,getlocal,0.000889601189483568,30,9,21
1346,1346,also,0.0008706891333033233,14,3,11
1347,1347,r,0.0008686480743179629,44,24,20
1348,1348,default_keyword,0.000862845401623024,9,4,5
1349,1349,control,0.0008566304404995185,16,11,5
1350,1350,into,0.0008516173772261668,18,6,12
1351,1351,20,0.0008510170631082755,22,9,13
1352,1352,they,0.0008494469406945884,15,4,11
1353,1353,remote,0.0008419046711004947,52,24,28
1354,1354,dt,0.0008333066208165213,13,4,9
1355,1355,bla,0.0008333054770645392,11,8,3
1356,1356,excludes,0.0008317732167892108,11,5,6
1357,1357,does,0.0008298550524192525,53,22,31
1358,1358,//localhost,0.00082446780444137,22,15,7
1359,1359,fields,0.0008234463641206666,22,8,14
1360,1360,apache,0.0008197347538292776,35,22,13
1361,1361,sys,0.0008181942704231625,38,23,15
1362,1362,updated,0.0008139832392408666,13,8,5
1363,1363,modification,0.0008024455864543709,14,8,6
1364,1364,slow,0.0008024448554984627,6,2,4
1365,1365,skip,0.0008006980867061309,30,16,14
1366,1366,find,0.0007981115810682914,40,19,21
1367,1367,save,0.0007979330188325959,17,7,10
1368,1368,assertnull,0.0007941642852646591,125,74,51
1369,1369,did,0.0007902973004380656,36,18,18
1370,1370,lookup,0.0007901561952008617,24,9,15
1371,1371,disabled,0.0007881032585720571,20,9,11
1372,1372,uuid,0.0007798057615724351,16,11,5
1373,1373,filename,0.0007757329914345229,35,18,17
1374,1374,ensure,0.0007741286437007878,52,23,29
1375,1375,createremoteuser,0.0007707409745496274,29,9,20
1376,1376,getuser,0.0007707409745496274,29,20,9
1377,1377,expiration,0.0007674149091067804,12,5,7
1378,1378,/a,0.0007674147262377272,10,6,4
1379,1379,redirect,0.000752093541979461,26,13,13
1380,1380,didn\,0.000752013239713939,22,9,13
1381,1381,rw,0.0007505243768347186,16,4,12
1382,1382,than,0.0007469161317869418,47,23,24
1383,1383,eq,0.0007436018678396604,92,46,46
1384,1384,text/plain,0.000743193229664364,9,2,7
1385,1385,priority,0.0007421720430214494,7,2,5
1386,1386,91,0.0007421712236347798,3,0,3
1387,1387,day\,0.0007421712236347798,3,3,0
1388,1388,pipes,0.0007421712236347798,3,3,0
1389,1389,q=0,0.0007421712236347798,3,0,3
1390,1390,uber,0.0007421712236347798,3,3,0
1391,1391,{},0.0007416621115054383,11,6,5
1392,1392,overwrite,0.0007416619746478002,5,3,2
1393,1393,hook,0.0007416619291584657,3,1,2
1394,1394,u,0.0007384674530960932,39,19,20
1395,1395,existing,0.0007240162352630647,27,10,17
1396,1396,register,0.0007206133290513072,54,25,29
1397,1397,group_,0.0007081707647541703,23,9,14
1398,1398,///,0.0007081638775656841,11,3,8
1399,1399,expire,0.0007067173592267672,18,7,11
1400,1400,adding,0.0006777699530312051,11,8,3
1401,1401,wrong,0.0006769335215612354,28,11,17
1402,1402,out,0.0006759898915457692,202,98,104
1403,1403,right,0.0006700210353993334,14,4,10
1404,1404,properly,0.0006687420456040387,12,8,4
1405,1405,doas,0.0006683118142484187,31,12,19
1406,1406,utf8,0.0006677201731028109,20,10,10
1407,1407,too,0.0006526542740342527,30,15,15
1408,1408,email,0.0006520613483105863,9,3,6
1409,1409,another,0.0006459936067958424,37,16,21
1410,1410,level,0.0006451658401912279,59,25,34
1411,1411,memory,0.0006417187758827915,15,6,9
1412,1412,isempty,0.0006348306104633286,35,12,23
1413,1413,unchecked,0.0006348306104633286,35,12,23
1414,1414,using,0.000616532385619028,36,19,17
1415,1415,disk,0.000615837465900544,10,4,6
1416,1416,sb,0.00060886756666567,15,11,4
1417,1417,failover,0.0006026916970122611,27,12,15
1418,1418,were,0.00060268962342723,17,7,10
1419,1419,null_keyword,0.0006002631707841721,21,9,12
1420,1420,filesystem,0.000595656557984642,76,38,38
1421,1421,day,0.0005919173666769553,12,8,4
1422,1422,per,0.0005885784484014928,33,20,13
1423,1423,instead,0.0005845099501910105,10,5,5
1424,1424,m,0.0005845099501910105,36,18,18
1425,1425,paths,0.0005825059382983961,23,11,12
1426,1426,unexpected,0.0005798065556624917,37,23,14
1427,1427,/foo,0.0005797962357736216,23,10,13
1428,1428,used,0.0005672373108994554,30,13,17
1429,1429,removed,0.0005668871136259618,20,10,10
1430,1430,cannot,0.0005662088076423943,14,7,7
1431,1431,both,0.000561140583342628,34,17,17
1432,1432,getfilestatus,0.0005588296904703253,48,27,21
1433,1433,which,0.0005588120254024272,27,13,14
1434,1434,configured,0.0005550544027033547,13,6,7
1435,1435,loader,0.0005504135965450152,16,9,7
1436,1436,finish,0.0005497783114425487,33,17,16
1437,1437,successfully,0.0005465445308828615,16,6,10
1438,1438,assert_keyword,0.0005303675791153237,7,4,3
1439,1439,short,0.0005281245779356512,34,15,19
1440,1440,getvalue,0.0005267379597776456,90,37,53
1441,1441,ioe,0.0005237296079376951,25,15,10
1442,1442,=>,0.0005205342048270152,9,3,6
1443,1443,len,0.000516781926467003,42,21,21
1444,1444,checker,0.0005161520766634835,20,12,8
1445,1445,few,0.0005148273779881953,11,7,4
1446,1446,1234,0.0005143166247378352,11,5,6
1447,1447,root_,0.0005115817834941243,29,10,19
1448,1448,fc,0.0005106957458277297,13,6,7
1449,1449,collections,0.0005083412811051034,36,23,13
1450,1450,conn,0.0005066071392027909,105,52,53
1451,1451,see,0.0005038523451505027,21,10,11
1452,1452,private_keyword,0.0005022184009577258,27,13,14
1453,1453,test1,0.0004946548631498422,18,8,10
1454,1454,google,0.0004946537651434896,6,2,4
1455,1455,static_keyword,0.0004946534012324772,2,0,2
1456,1456,${hadoop,0.0004946534012324772,2,2,0
1457,1457,<sla,0.0004946534012324772,2,2,0
1458,1458,eaaaa//9,0.0004946534012324772,2,2,0
1459,1459,h\,0.0004946534012324772,2,2,0
1460,1460,kbaaaap//,0.0004946534012324772,2,2,0
1461,1461,qaaad//0o,0.0004946534012324772,2,2,0
1462,1462,sean,0.0004946534012324772,2,0,2
1463,1463,sg,0.0004946534012324772,2,2,0
1464,1464,errors,0.0004929525142793306,20,10,10
1465,1465,allow,0.0004911633422309239,13,9,4
1466,1466,qualified,0.0004900184773898439,20,11,9
1467,1467,seconds,0.00048241090686185206,30,12,18
1468,1468,getpath,0.0004777671797626601,65,39,26
1469,1469,shouldn\,0.00047601209184204053,14,10,4
1470,1470,iterator,0.0004711343382838703,25,10,15
1471,1471,ns,0.0004554591334785603,21,13,8
1472,1472,test_,0.0004377346207711224,78,33,45
1473,1473,this_keyword,0.00043387088429282846,5,2,3
1474,1474,parser,0.00040558659133036606,52,28,24
1475,1475,else_keyword,0.00040065828168813714,45,20,25
1476,1476,isequalto,0.0003972229361850453,46,28,18
1477,1477,above,0.000395215045022569,12,5,7
1478,1478,over,0.0003892600325454236,16,6,10
1479,1479,getproperty,0.00038916486319779536,30,19,11
1480,1480,protected_keyword,0.00037423591969821396,8,6,2
1481,1481,12,0.0003727932517096676,18,7,11
1482,1482,able,0.000372791783504277,14,9,5
1483,1483,again,0.00036844729560519575,41,21,20
1484,1484,float_keyword,0.0003684465110972788,7,4,3
1485,1485,test_root_dir,0.00035736118915287787,25,9,16
1486,1486,its,0.00034775553252794486,24,13,11
1487,1487,receive,0.0003448694223649562,40,21,19
1488,1488,concurrent,0.0003334161539360115,13,7,6
1489,1489,getdata,0.0003304845761531866,27,17,10
1490,1490,utf-8,0.00031835043852443184,21,10,11
1491,1491,setproperty,0.0003144568478630136,47,28,19
1492,1492,synchronized_keyword,0.000308045828505158,4,1,3
1493,1493,just,0.000298897191312735,15,9,6
1494,1494,it\,0.0002944700840028418,12,4,8
1495,1495,doesn\,0.0002924712527836914,17,10,7
1496,1496,none,0.00028335987188040724,12,5,7
1497,1497,containskey,0.00026994869151507686,33,20,13
1498,1498,9,0.00026705335814052305,14,7,7
1499,1499,l,0.0002609296503547744,18,9,9
1500,1500,don\,0.00025769469707133483,18,9,9
1501,1501,getabsolutepath,0.0002514503132875351,26,10,16
1502,1502,incr,0.00024726340404492095,17,9,8
1503,1503,byte_keyword,0.00024726308425122943,3,1,2
1504,1504,case_keyword,0.00024726303882684295,1,1,0
1505,1505,implements_keyword,0.00024726303882684295,1,0,1
1506,1506,native_keyword,0.00024726303882684295,1,0,1
1507,1507,volatile_keyword,0.00024726303882684295,1,0,1
1508,1508,${env,0.00024726303882684295,1,0,1
1509,1509,${wf,0.00024726303882684295,1,1,0
1510,1510,/log/debug-old-2010-08-10,0.00024726303882684295,1,0,1
1511,1511,hour\,0.00024726303882684295,1,1,0
1512,1512,justo,0.00024726303882684295,1,0,1
1513,1513,owen,0.00024726303882684295,1,0,1
1514,1514,getinputstream,0.00023532005528928424,63,36,27
1515,1515,assertfalse,0.00021721074775346572,337,159,178
1516,1516,let,0.0002093744274383109,14,5,9
1517,1517,getting,0.00020703711172485179,15,9,6
1518,1518,stringutils,0.00019812472067608916,45,26,19
1519,1519,still,0.00019142705721882092,34,19,15
1520,1520,false_keyword,0.00018686249270244946,4,1,3
1521,1521,through,0.00018234960109900136,11,4,7
1522,1522,filesys,0.00018112905209113558,25,15,10
1523,1523,countdown,0.0001560985449311561,29,17,12
1524,1524,already,0.00011063824328897982,26,14,12
1525,1525,touri,0.00010552199336969631,43,24,19
1526,1526,addheader,0.00010088545215230366,45,25,20
1527,1527,binary,9.224014636520332e-05,19,8,11
1528,1528,many,9.03674916329809e-05,22,10,12
1529,1529,yet,8.539656203099613e-05,19,11,8
1530,1530,getcause,8.0446475418057e-05,36,16,20
1531,1531,sink1,6.065542074230575e-05,7,4,3
1532,1532,sink2,6.065542074230575e-05,7,4,3
1533,1533,true_keyword,6.065537518830074e-05,5,2,3
1534,1534,setconf,5.595763691416261e-05,52,24,28
1535,1535,getname,4.206474821320805e-05,162,84,78
1536,1536,setlong,3.975852743977326e-05,41,19,22
1537,1537,gettype,2.5752459153011165e-05,28,15,13
1538,1538,val,2.4727494011469314e-05,32,16,16
1539,1539,//www,1.1960536528096352e-05,15,8,7
1540,1540,100,1.055925620901954e-05,17,9,8
1541,1541,abstract_keyword,0.0,0,0,0
1542,1542,break_keyword,0.0,0,0,0
1543,1543,char_keyword,0.0,2,1,1
1544,1544,continue_keyword,0.0,0,0,0
1545,1545,enum_keyword,0.0,0,0,0
1546,1546,exports_keyword,0.0,0,0,0
1547,1547,import_keyword,0.0,0,0,0
1548,1548,interface_keyword,0.0,0,0,0
1549,1549,modules_keyword,0.0,2,1,1
1550,1550,package_keyword,0.0,0,0,0
1551,1551,strictfp_keyword,0.0,0,0,0
1552,1552,super_keyword,0.0,0,0,0
1553,1553,switch_keyword,0.0,0,0,0
1554,1554,transient_keyword,0.0,0,0,0
1555,1555,const_keyword,0.0,0,0,0
1556,1556,goto_keyword,0.0,0,0,0
1557,1557,getcode,0.0,30,15,15
